question,m1,m2,m3,m4,m5,m6,m7,m8,all
Accept,4,1,2,3,15,9,2,0,36
Emphasis,59,49,27,17,88,22,20,18,300
Greet,0,0,0,1,1,1,0,0,3
nAnswer,13,7,3,9,19,13,16,0,80
Other,9,7,4,2,8,11,12,2,55
Reject,23,28,16,17,32,27,22,3,168
Statement,117,190,145,100,147,256,142,50,1147
System,5,9,11,9,2,20,15,3,74
whQuestion,51,47,26,30,85,49,49,21,358
yAnswer,4,2,3,8,13,7,3,2,42
ynQuestion,30,39,14,26,28,33,28,17,215