question,m1,m2,m3,m4,m5,m6,m7,m8,all
Accept,1,1,0,0,0,1,0,1,4
Emphasis,21,16,34,14,34,8,29,26,182
Greet,0,0,0,0,1,0,0,0,1
nAnswer,5,9,5,6,6,12,11,6,60
Other,3,9,4,2,10,8,13,4,53
Reject,13,14,23,11,18,7,20,6,112
Statement,53,84,82,37,76,91,127,42,592
System,6,4,3,3,0,8,11,2,37
whQuestion,21,13,17,16,12,18,23,19,139
yAnswer,0,3,3,2,4,1,3,1,17
ynQuestion,13,13,7,12,2,18,12,5,82