question,m1,m2,m3,m4,m5,m6,m7,m8,all
Accept,1,1,1,0,1,3,4,1,12
Emphasis,54,37,19,5,29,9,23,34,210
Greet,1,2,0,1,1,0,1,1,7
nAnswer,3,26,16,1,0,16,7,3,72
Other,4,18,13,4,2,15,10,7,73
Reject,16,35,7,11,7,9,22,16,123
Statement,63,154,81,71,30,91,104,43,637
System,5,18,12,1,2,9,10,5,62
whQuestion,13,39,16,11,15,22,28,16,160
yAnswer,0,1,0,2,1,0,2,1,7
ynQuestion,13,17,6,10,4,19,10,15,94